b b b b b b b b b b b b b b b b b b b b b b b b b b b b b b
b h e e e e e e e e e e e e e e e e e e e e e e e e e e e b
b e b b b b b e b b b b e b b b b b e b b b b b b b b b e b
b e e e e e b e b b e e e b b b b b e e e b b e e e e e e b
b e b b b e b e b b e b e b b b b b e b e b b e b b b b e b
b e b b b e b e b b e b e b b b b b e b e b b e b b b b e b
b e b b b e b e b b e b e e e e e e e b e b b e b b b b e b
b e b b b e b e b b e b e b b b b b e b e b b e b b b b e b
b e b b b e b e b b e b e b b b b b e b e b b e b b b b e b
b e b b b e b e b b e b e b b b b b e b e b b e b b b b e b
b e b b b e b e b b e b e b b b b b e b e b b e b b b b e b
b e b b b e b e e e e b e e e e e e e b e e e e e e e e e b
b e b b b e b b b b b b b e b b b e b b b b b b b b b b e b
b i b b b e e e e e e e e e e e e e e e e e e e b b b b a b
b b b b b b b b b b b b b b b b b b b b b b b b b b b b b b
