b b b b b b b b b b b b b b b b b b b b
b g g g g g g b g b g g g g g c m m m m
b g g g g g g b g b g b g g g b m m m m
b g g b a b g b g b g b g g g b m m m m
b g g c g b g c g b g b g g g b m m m m
b g g b g b g b g b g c g g g b m m m m
b g g b g b g b g c g b g b b c m m m m
b g g b g c g b g b g b g g g b m m m m
b g g b g b g g g b g b g c g b m m m m
b g g b g b g g g b g b g b g b m m m m
b g g b g b g g g c g b g b g b m m m m
b g g b g b g b g b g b g b g c m m m m
b g g c g c g b g b g b g b g b m m m m
b g g g g b g b g b g b g c g b m m m m
b g g g g b g b g c g b g b g b m m m m
b g b b b b g b g b g b g b g b m m m m
b g g g g c g c g b g c g b g b m m m m
b g g b g g g b g b g b g g g b m m m m
b h g b g g g g g g g g g b b c m m m m
b b b b b b b b b b b b b b b b b b b b
